6
5
+-+-+-+-+-+-+
|S| | |   | |
+ + + + + + +
|       | | |
+ +-+ +-+ + +
| | | | |   |
+ + + + +-+ +
|   |   |E| |
+-+-+ +-+ + |
|           |
+-+-+-+-+-+-|
